4444444000044444444
4440000004444444444
4440000044444444444
4444444444444444444
4444444444444444444
4444000444444444444
4444000004444444444
4400000044444444444
4444444444444444444
4444444444444444444
4444444444400004444
4444444444400004444
4444444444444444444