33333333111122
11111113111111
11111133311111
12221133333333
22211133311112
11222111111222
11112222222211