11111111111122111111
11111111111122111111
11111111111112211111
33333333331111222111
11111111131111112211
11111111333111112211
11122211333333333333
11222111333111122111
11112221111112221111
11111122222222111111
11111111221111111111
11111112211111111111
11111112211111111111
