3333333311112221
1111111311111121
1111113331111122
1222113333333333
2221113331111221
1122211111122211
1111222222221111